DKKKKKKKKKKKD
KZKZKZKZKZKZK
KTKTKTKTKTKTK
KZKZKZKZKZKZK
DTKTKTDTKTKTD
KKKKKKKKKKKKK
TKSSKKTKKSSKT
KCCCCZCZCCCCK
KZKZKZKZKZKZK
KZKZKZKZKZKZK
KZKZKKKKKZKZK
KKKKKKKKKKKKK